{
  "levels": [
    {
      "levelName": "Level Test",
      "rows": "10",
      "columns": "5",
      "description": "Level Test : Used for testing purposes. ",
      "tileConfig": [
        "1,1,1,1,1",
        "1,1,1,1,1",
        "1,1,1,1,1",
        "1,1,1,1,1",
        "1,1,1,1,1",
        "1,1,1,1,1",
        "1,1,1,1,1",
        "1,1,1,1,1",
        "1,1,1,1,1",
        "1,1,1,1,1"
      ]
    },
    {
      "levelName": "Level One",
      "rows": "15",
      "columns": "10",
      "description": "Level One : This will be the first proper level. ",
      "tileConfig": [
        "1,1,1,1,1,1,1,1,1,1",
        "1,1,1,1,1,1,1,1,1,1",
        "1,1,1,1,1,1,1,1,1,1",
        "1,1,1,1,1,1,1,1,1,1",
        "1,1,1,1,1,1,1,1,1,1",
        "1,1,1,1,1,1,1,1,1,1",
        "1,1,1,1,1,1,1,1,1,1",
        "1,1,1,1,1,1,1,1,1,1",
        "1,1,1,1,1,1,1,1,1,1",
        "1,1,1,1,1,1,1,1,1,1",
        "2,2,2,2,1,1,2,2,2,2",
        "1,1,1,1,1,1,1,1,1,1",
        "1,1,1,1,1,1,1,1,1,1",
        "1,1,1,1,1,1,1,1,1,1",
        "1,1,1,1,1,1,1,1,1,1"
      ]
    }
  ]
}
