{
  "levels": [
    {
      "levelName": "Level Test",
      "rows": "10",
      "columns": "5",
      "description": "Level Test : Used for testing purposes. ",
      "tileConfig": [
        "1","1","1","1","1",
        "1","1","1","1","1",
        "1","1","1","1","1",
        "1","1","1","1","1",
        "1","1","1","1","1",
        "1","1","1","1","1",
        "1","1","1","1","1",
        "1","1","1","1","1",
        "1","1","1","1","1",
        "1","1","1","1","1"
      ],
      "playerPoints": [ "0", "1", "2", "1", "0", "3", "2", "3"],
      "aiPoints": [ "9", "3", "7", "3", "9", "1", "7", "1" ]
    },
    {
      "levelName": "Level One",
      "rows": "15",
      "columns": "10",
      "description": "Level One : This will be the first proper level. It is a large open grassland with endless posibilities. ",
      "tileConfig": [
        "1","1","1","1","1","1","1","1","1","1",
        "1","1","1","1","1","1","1","1","1","1",
        "1","1","1","1","1","1","1","1","1","1",
        "1","1","1","1","1","1","1","1","1","1",
        "1","1","1","1","1","1","1","1","1","1",
        "1","1","1","1","1","1","1","1","1","1",
        "1","1","1","1","1","1","1","1","1","1",
        "1","1","1","1","1","1","1","1","1","1",
        "1","1","1","1","1","1","1","1","1","1",
        "1","1","1","1","1","1","1","1","1","1",
        "1","1","1","1","1","1","1","1","1","1",
        "1","1","1","1","1","1","1","1","1","1",
        "1","1","1","1","1","1","1","1","1","1",
        "1","1","1","1","1","1","1","1","1","1",
        "1","1","1","1","1","1","1","1","1","1"
      ],
      "playerPoints": [ "0", "5", "0", "3", "0", "7", "2", "5"],
      "aiPoints": [ "14", "5", "14", "3", "14", "7", "12", "5" ]
    },
    {
      "levelName": "Level Two",
      "rows": "15",
      "columns": "10",
      "description": "Level Two : This will be used to test level switching. ",
      "tileConfig": [
        "1","1","1","1","1","1","1","1","1","1",
        "1","1","1","1","1","1","1","1","1","1",
        "1","1","1","1","1","1","1","1","1","1",
        "1","1","1","1","1","1","1","1","1","1",
        "2","2","2","2","1","1","2","1","1","1",
        "2","2","2","2","1","1","2","2","1","1",
        "1","1","1","1","1","1","1","2","2","1",
        "1","1","1","1","1","1","1","1","2","2",
        "1","1","1","1","1","1","1","1","1","2",
        "1","1","1","1","1","1","1","1","1","1",
        "1","1","1","1","1","1","1","1","1","1",
        "1","1","1","1","1","1","1","1","1","1",
        "1","1","1","1","1","1","1","1","1","1",
        "1","1","1","1","1","1","1","1","1","1",
        "1","1","1","1","1","1","1","1","1","1"
      ],
      "playerPoints": [ "0", "5", "0", "3", "0", "7", "2", "5" ],
      "aiPoints": [ "14", "5", "14", "3", "14", "7", "12", "5" ]
    }
  ]
}
